############
#         O#
#   P   ####
#          #
#######    #
#    ##    #
#    ##    #
#          #
#  O    XX #
#       #  #
############